annoying: molesto.
arrangements: los planes, los arreglos.
arrange: concertar.
avoid: evitar.
along with: junto con.
belongings: pertenencias.
break into: irrumpir.
burglar: ladrón.
chief: jefe.
doll: muñeca.
early riser: madrugador.
either: ambos, cualquiera de los dos.
enough: sufuciente.
every now and then/again: de vez en cuando.
every other day: cualquier otro día.
forward: reenviar.
from time to time: de vez en cuando.
gang: banda de.
gather: comprensión.
grab: tomar, agarrar.
hardly ever: casi nunca.
hold: esperar, sostener.
hourly: por hora.
lately: últimamente.
leaflet: folleto.
Let's imagine: imaginemos...
lifelike: realistas.
mind: importar.
neighbourhood: el barrio.
now and again: una y otra vez, de vez en cuando.
noon: mediodía.
nursery: guardería.
once in a while: de vez en cuando.
once: una vez.
owner: dueño.
pick up: coger (el teléfono).
pity: la lástima.
pleasant: agradable.
quite: totalmente, bastante...
rag: trapo.
reach: contactar (reached: contactado).
ring: anillo.
rush off for: salir corriendo para tomar/coger
scarcely: apenas.
seamlessly: sin problemas, sin costuras.
seldom: rara vez.
slot: hueco, ranuca.
smoothly: suavemente.
stamina: resistencia.
tense: tiempo verbal.
thieves: ladrones.
twice: dos veces.
vowels: vocales.
waiter: camarero, mesero.
wealth: abundancia.
